15
10
        #
       ########
          #
     ######
     #   @
#############
     #      ##
     ##      ##
     #
     #